src/clients/kdestroy/kdestroy.c	usr/src/cmd/krb5/kdestroy/kdestroy.c
src/clients/kinit/kinit.c	usr/src/cmd/krb5/kinit/kinit.c
src/clients/klist/klist.c	usr/src/cmd/krb5/klist/klist.c
src/clients/kpasswd/kpasswd.c	usr/src/cmd/krb5/kadmin/kpasswd/kpasswd.c
src/clients/kpasswd/ksetpwd.c	NOTFOUND
src/clients/kvno/kvno.c	NOTFOUND
src/include/CredentialsCache.h	NOTFOUND
src/include/CredentialsCache2.h	NOTFOUND
src/include/adm.h	usr/src/lib/gss_mechs/mech_krb5/include/krb5/adm.h
src/include/adm_proto.h	usr/src/lib/gss_mechs/mech_krb5/include/krb5/adm_proto.h
src/include/cm.h	usr/src/lib/gss_mechs/mech_krb5/include/cm.h
src/include/copyright.h	usr/src/lib/gss_mechs/mech_krb5/include/krb5/copyright.h
src/include/fake-addrinfo.h	usr/src/lib/gss_mechs/mech_krb5/include/fake-addrinfo.h
src/include/foreachaddr.h	usr/src/lib/gss_mechs/mech_krb5/include/foreachaddr.h
src/include/gssapi.h	NO
src/include/gssrpc/auth.h	NO
src/include/gssrpc/auth_gss.h	NOTFOUND
src/include/gssrpc/auth_gssapi.h	NOTFOUND
src/include/gssrpc/auth_unix.h	NO
src/include/gssrpc/clnt.h	NO
src/include/gssrpc/netdb.h	NO
src/include/gssrpc/pmap_clnt.h	NO
src/include/gssrpc/pmap_prot.h	usr/src/lib/libbc/inc/include/rpc/pmap_prot.h
src/include/gssrpc/pmap_rmt.h	NO
src/include/gssrpc/rename.h	NOTFOUND
src/include/gssrpc/rpc.h	NO
src/include/gssrpc/rpc_msg.h	NO
src/include/gssrpc/svc.h	NO
src/include/gssrpc/svc_auth.h	NO
src/include/gssrpc/xdr.h	NO
src/include/iprop.h	NOTFOUND
src/include/iprop_hdr.h	usr/src/cmd/krb5/iprop/iprop_hdr.h
src/include/k5-buf.h	NOTFOUND
src/include/k5-err.h	usr/src/lib/gss_mechs/mech_krb5/include/krb5/k5-err.h
src/include/k5-gmt_mktime.h	NOTFOUND
src/include/k5-int-pkinit.h	usr/src/lib/gss_mechs/mech_krb5/include/k5-int-pkinit.h
src/include/k5-int.h	usr/src/uts/common/gssapi/mechs/krb5/include/k5-int.h
src/include/k5-ipc_stream.h	NOTFOUND
src/include/k5-platform.h	usr/src/uts/common/gssapi/mechs/krb5/include/k5-platform.h
src/include/k5-plugin.h	usr/src/lib/gss_mechs/mech_krb5/include/krb5/k5-plugin.h
src/include/k5-thread.h	usr/src/uts/common/gssapi/mechs/krb5/include/k5-thread.h
src/include/k5-unicode.h	NOTFOUND
src/include/k5-utf8.h	usr/src/lib/gss_mechs/mech_krb5/include/k5-utf8.h
src/include/k5-util.h	NOTFOUND
src/include/kdb.h	usr/src/lib/gss_mechs/mech_krb5/include/krb5/kdb.h
src/include/kdb_ext.h	NOTFOUND
src/include/kdb_kt.h	usr/src/lib/gss_mechs/mech_krb5/include/kdb_kt.h
src/include/kdb_log.h	usr/src/lib/krb5/kdb/kdb_log.h
src/include/krb5/authdata_plugin.h	NOTFOUND
src/include/krb5/locate_plugin.h	usr/src/lib/gss_mechs/mech_krb5/include/locate_plugin.h
src/include/krb5/preauth_plugin.h	usr/src/lib/gss_mechs/mech_krb5/include/preauth_plugin.h
src/include/krb5.h	usr/src/uts/common/gssapi/mechs/krb5/include/krb5.h
src/include/krb54proto.h	NOTFOUND
src/include/pkinit_apple_utils.h	NOTFOUND
src/include/pkinit_asn1.h	NOTFOUND
src/include/pkinit_cert_store.h	NOTFOUND
src/include/pkinit_client.h	NOTFOUND
src/include/pkinit_cms.h	NOTFOUND
src/include/port-sockets.h	usr/src/lib/gss_mechs/mech_krb5/include/port-sockets.h
src/include/socket-utils.h	usr/src/lib/gss_mechs/mech_krb5/include/socket-utils.h
src/include/spnego-asn1.h	NOTFOUND
src/include/win-mac.h	NOTFOUND
src/kadmin/cli/kadmin.c	usr/src/cmd/krb5/kadmin/cli/kadmin.c
src/kadmin/cli/kadmin.h	usr/src/cmd/krb5/kadmin/cli/kadmin.h
src/kadmin/cli/keytab.c	usr/src/cmd/krb5/kadmin/cli/keytab.c
src/kadmin/cli/keytab_local.c	NOTFOUND
src/kadmin/cli/ss_wrapper.c	usr/src/cmd/krb5/kadmin/cli/ss_wrapper.c
src/kadmin/cli/strftime.c	NO
src/kadmin/dbutil/dump.c	usr/src/cmd/krb5/kadmin/dbutil/dump.c
src/kadmin/dbutil/kadm5_create.c	usr/src/cmd/krb5/kadmin/dbutil/kadm5_create.c
src/kadmin/dbutil/kdb5_create.c	usr/src/cmd/krb5/kadmin/dbutil/kdb5_create.c
src/kadmin/dbutil/kdb5_destroy.c	usr/src/cmd/krb5/kadmin/dbutil/kdb5_destroy.c
src/kadmin/dbutil/kdb5_mkey.c	NOTFOUND
src/kadmin/dbutil/kdb5_stash.c	usr/src/cmd/krb5/kadmin/dbutil/kdb5_stash.c
src/kadmin/dbutil/kdb5_util.c	usr/src/cmd/krb5/kadmin/dbutil/kdb5_util.c
src/kadmin/dbutil/kdb5_util.h	usr/src/cmd/krb5/kadmin/dbutil/kdb5_util.h
src/kadmin/dbutil/nstrtok.h	usr/src/cmd/krb5/kadmin/dbutil/nstrtok.h
src/kadmin/dbutil/ovload.c	usr/src/cmd/krb5/kadmin/dbutil/ovload.c
src/kadmin/dbutil/string_table.c	usr/src/cmd/krb5/kadmin/dbutil/string_table.c
src/kadmin/dbutil/string_table.h	usr/src/cmd/krb5/kadmin/dbutil/string_table.h
src/kadmin/dbutil/strtok.c	usr/src/cmd/krb5/kadmin/dbutil/strtok.c
src/kadmin/ktutil/ktutil.c	usr/src/cmd/krb5/kadmin/ktutil/ktutil.c
src/kadmin/ktutil/ktutil.h	usr/src/cmd/krb5/kadmin/ktutil/ktutil.h
src/kadmin/ktutil/ktutil_funcs.c	usr/src/cmd/krb5/kadmin/ktutil/ktutil_funcs.c
src/kadmin/passwd/kpasswd.c	usr/src/cmd/krb5/kadmin/kpasswd/kpasswd.c
src/kadmin/passwd/kpasswd.h	usr/src/cmd/krb5/kadmin/kpasswd/kpasswd.h
src/kadmin/passwd/tty_kpasswd.c	usr/src/cmd/krb5/kadmin/kpasswd/tty_kpasswd.c
src/kadmin/passwd/xm_kpasswd.c	NOTFOUND
src/kadmin/server/ipropd_svc.c	usr/src/cmd/krb5/kadmin/server/ipropd_svc.c
src/kadmin/server/kadm_rpc_svc.c	usr/src/cmd/krb5/kadmin/server/kadm_rpc_svc.c
src/kadmin/server/misc.c	usr/src/cmd/krb5/kadmin/server/misc.c
src/kadmin/server/misc.h	usr/src/cmd/krb5/kadmin/server/misc.h
src/kadmin/server/network.c	usr/src/cmd/krb5/krb5kdc/network.c
src/kadmin/server/ovsec_kadmd.c	usr/src/cmd/krb5/kadmin/server/ovsec_kadmd.c
src/kadmin/server/schpw.c	NOTFOUND
src/kadmin/server/server_glue_v1.c	usr/src/cmd/krb5/kadmin/server/server_glue_v1.c
src/kadmin/server/server_stubs.c	usr/src/cmd/krb5/kadmin/server/server_stubs.c
src/kdc/dispatch.c	usr/src/cmd/krb5/krb5kdc/dispatch.c
src/kdc/do_as_req.c	usr/src/cmd/krb5/krb5kdc/do_as_req.c
src/kdc/do_tgs_req.c	usr/src/cmd/krb5/krb5kdc/do_tgs_req.c
src/kdc/extern.c	usr/src/cmd/krb5/krb5kdc/extern.c
src/kdc/extern.h	usr/src/cmd/krb5/krb5kdc/extern.h
src/kdc/fast_util.c	NOTFOUND
src/kdc/kdc_authdata.c	NOTFOUND
src/kdc/kdc_preauth.c	usr/src/cmd/krb5/krb5kdc/kdc_preauth.c
src/kdc/kdc_util.c	usr/src/cmd/krb5/krb5kdc/kdc_util.c
src/kdc/kdc_util.h	usr/src/cmd/krb5/krb5kdc/kdc_util.h
src/kdc/main.c	usr/src/cmd/krb5/krb5kdc/main.c
src/kdc/network.c	usr/src/cmd/krb5/krb5kdc/network.c
src/kdc/pkinit_apple_server.c	NOTFOUND
src/kdc/pkinit_server.h	NOTFOUND
src/kdc/policy.c	usr/src/cmd/krb5/krb5kdc/policy.c
src/kdc/policy.h	usr/src/cmd/krb5/krb5kdc/policy.h
src/kdc/replay.c	usr/src/cmd/krb5/krb5kdc/replay.c
src/kdc/rtest.c	NOTFOUND
src/lib/glue4.c	usr/src/cmd/refer/glue4.c
src/lib/gssapi/generic/disp_com_err_status.c	usr/src/lib/gss_mechs/mech_krb5/mech/disp_com_err_status.c
src/lib/gssapi/generic/disp_major_status.c	usr/src/lib/gss_mechs/mech_krb5/mech/disp_major_status.c
src/lib/gssapi/generic/gssapiP_generic.h	usr/src/uts/common/gssapi/mechs/krb5/include/gssapiP_generic.h
src/lib/gssapi/generic/gssapi_ext.h	usr/src/uts/common/gssapi/gssapi_ext.h
src/lib/gssapi/generic/gssapi_generic.c	NOTFOUND
src/lib/gssapi/generic/gssapi_generic.h	usr/src/uts/common/gssapi/mechs/krb5/include/gssapi_generic.h
src/lib/gssapi/generic/maptest.c	NOTFOUND
src/lib/gssapi/generic/oid_ops.c	usr/src/lib/gss_mechs/mech_krb5/mech/oid_ops.c
src/lib/gssapi/generic/oid_ops.c	usr/src/lib/libgss/oid_ops.c
src/lib/gssapi/generic/rel_buffer.c	usr/src/lib/gss_mechs/mech_krb5/mech/rel_buffer.c
src/lib/gssapi/generic/rel_oid_set.c	usr/src/lib/gss_mechs/mech_krb5/mech/rel_oid_set.c
src/lib/gssapi/generic/util_buffer.c	usr/src/lib/gss_mechs/mech_krb5/mech/util_buffer.c
src/lib/gssapi/generic/util_buffer_set.c	usr/src/lib/gss_mechs/mech_krb5/mech/util_buffer_set.c
src/lib/gssapi/generic/util_canonhost.c	NOTFOUND
src/lib/gssapi/generic/util_errmap.c	usr/src/lib/gss_mechs/mech_krb5/mech/util_errmap.c
src/lib/gssapi/generic/util_localhost.c	usr/src/lib/gss_mechs/mech_krb5/mech/util_localhost.c
src/lib/gssapi/generic/util_ordering.c	usr/src/uts/common/gssapi/mechs/krb5/mech/util_ordering.c
src/lib/gssapi/generic/util_set.c	usr/src/uts/common/gssapi/mechs/krb5/mech/util_set.c
src/lib/gssapi/generic/util_token.c	usr/src/uts/common/gssapi/mechs/krb5/mech/util_token.c
src/lib/gssapi/generic/util_validate.c	usr/src/uts/common/gssapi/mechs/krb5/mech/util_validate.c
src/lib/gssapi/generic/utl_nohash_validate.c	usr/src/lib/gss_mechs/mech_krb5/mech/utl_nohash_validate.c
src/lib/gssapi/krb5/accept_sec_context.c	usr/src/lib/gss_mechs/mech_krb5/mech/accept_sec_context.c
src/lib/gssapi/krb5/acquire_cred.c	usr/src/lib/gss_mechs/mech_krb5/mech/acquire_cred.c
src/lib/gssapi/krb5/add_cred.c	usr/src/lib/gss_mechs/mech_krb5/mech/add_cred.c
src/lib/gssapi/krb5/canon_name.c	NOTFOUND
src/lib/gssapi/krb5/compare_name.c	usr/src/lib/gss_mechs/mech_krb5/mech/compare_name.c
src/lib/gssapi/krb5/context_time.c	usr/src/lib/gss_mechs/mech_krb5/mech/context_time.c
src/lib/gssapi/krb5/copy_ccache.c	usr/src/lib/gss_mechs/mech_krb5/mech/copy_ccache.c
src/lib/gssapi/krb5/delete_sec_context.c	usr/src/uts/common/gssapi/mechs/krb5/mech/delete_sec_context.c
src/lib/gssapi/krb5/disp_name.c	usr/src/lib/gss_mechs/mech_krb5/mech/disp_name.c
src/lib/gssapi/krb5/disp_status.c	usr/src/lib/gss_mechs/mech_krb5/mech/disp_status.c
src/lib/gssapi/krb5/duplicate_name.c	NOTFOUND
src/lib/gssapi/krb5/export_name.c	usr/src/lib/gss_mechs/mech_krb5/mech/export_name.c
src/lib/gssapi/krb5/export_sec_context.c	usr/src/lib/gss_mechs/mech_krb5/mech/export_sec_context.c
src/lib/gssapi/krb5/get_tkt_flags.c	usr/src/lib/gss_mechs/mech_krb5/mech/get_tkt_flags.c
src/lib/gssapi/krb5/gssapiP_krb5.h	usr/src/uts/common/gssapi/mechs/krb5/include/gssapiP_krb5.h
src/lib/gssapi/krb5/gssapi_krb5.c	usr/src/uts/common/gssapi/mechs/krb5/mech/gssapi_krb5.c
src/lib/gssapi/krb5/import_name.c	usr/src/lib/gss_mechs/mech_krb5/mech/import_name.c
src/lib/gssapi/krb5/import_sec_context.c	usr/src/uts/common/gssapi/mechs/krb5/mech/import_sec_context.c
src/lib/gssapi/krb5/indicate_mechs.c	usr/src/lib/gss_mechs/mech_krb5/mech/indicate_mechs.c
src/lib/gssapi/krb5/init_sec_context.c	usr/src/lib/gss_mechs/mech_krb5/mech/init_sec_context.c
src/lib/gssapi/krb5/inq_context.c	usr/src/lib/gss_mechs/mech_krb5/mech/inq_context.c
src/lib/gssapi/krb5/inq_cred.c	usr/src/lib/gss_mechs/mech_krb5/mech/inq_cred.c
src/lib/gssapi/krb5/inq_names.c	usr/src/lib/gss_mechs/mech_krb5/mech/inq_names.c
src/lib/gssapi/krb5/k5seal.c	usr/src/uts/common/gssapi/mechs/krb5/mech/k5seal.c
src/lib/gssapi/krb5/k5sealiov.c	NOTFOUND
src/lib/gssapi/krb5/k5sealv3.c	usr/src/uts/common/gssapi/mechs/krb5/mech/k5sealv3.c
src/lib/gssapi/krb5/k5sealv3iov.c	NOTFOUND
src/lib/gssapi/krb5/k5unseal.c	usr/src/uts/common/gssapi/mechs/krb5/mech/k5unseal.c
src/lib/gssapi/krb5/k5unsealiov.c	NOTFOUND
src/lib/gssapi/krb5/krb5_gss_glue.c	usr/src/lib/gss_mechs/mech_krb5/mech/krb5_gss_glue.c
src/lib/gssapi/krb5/lucid_context.c	usr/src/lib/gss_mechs/mech_krb5/mech/lucid_context.c
src/lib/gssapi/krb5/process_context_token.c	usr/src/lib/gss_mechs/mech_krb5/mech/process_context_token.c
src/lib/gssapi/krb5/rel_cred.c	usr/src/lib/gss_mechs/mech_krb5/mech/rel_cred.c
src/lib/gssapi/krb5/rel_name.c	usr/src/lib/gss_mechs/mech_krb5/mech/rel_name.c
src/lib/gssapi/krb5/rel_oid.c	usr/src/lib/gss_mechs/mech_krb5/mech/rel_oid.c
src/lib/gssapi/krb5/seal.c	usr/src/uts/common/gssapi/mechs/krb5/mech/seal.c
src/lib/gssapi/krb5/ser_sctx.c	usr/src/uts/common/gssapi/mechs/krb5/mech/ser_sctx.c
src/lib/gssapi/krb5/set_allowable_enctypes.c	usr/src/lib/gss_mechs/mech_krb5/mech/set_allowable_enctypes.c
src/lib/gssapi/krb5/set_ccache.c	usr/src/lib/gss_mechs/mech_krb5/mech/set_ccache.c
src/lib/gssapi/krb5/sign.c	usr/src/uts/common/gssapi/mechs/krb5/mech/sign.c
src/lib/gssapi/krb5/unseal.c	usr/src/uts/common/gssapi/mechs/krb5/mech/unseal.c
src/lib/gssapi/krb5/util_cksum.c	usr/src/lib/gss_mechs/mech_krb5/mech/util_cksum.c
src/lib/gssapi/krb5/util_crypt.c	usr/src/uts/common/gssapi/mechs/krb5/mech/util_crypt.c
src/lib/gssapi/krb5/util_seed.c	usr/src/uts/common/gssapi/mechs/krb5/mech/util_seed.c
src/lib/gssapi/krb5/util_seqnum.c	usr/src/uts/common/gssapi/mechs/krb5/mech/util_seqnum.c
src/lib/gssapi/krb5/val_cred.c	usr/src/uts/common/gssapi/mechs/krb5/mech/val_cred.c
src/lib/gssapi/krb5/verify.c	usr/src/uts/common/gssapi/mechs/krb5/mech/verify.c
src/lib/gssapi/krb5/wrap_size_limit.c	usr/src/uts/common/gssapi/mechs/krb5/mech/wrap_size_limit.c
src/lib/gssapi/mechglue/g_accept_sec_context.c	usr/src/lib/libgss/g_accept_sec_context.c
src/lib/gssapi/mechglue/g_acquire_cred.c	usr/src/lib/libgss/g_acquire_cred.c
src/lib/gssapi/mechglue/g_buffer_set.c	usr/src/lib/libgss/g_buffer_set.c
src/lib/gssapi/mechglue/g_canon_name.c	usr/src/lib/libgss/g_canon_name.c
src/lib/gssapi/mechglue/g_compare_name.c	usr/src/lib/libgss/g_compare_name.c
src/lib/gssapi/mechglue/g_complete_auth_token.c	NOTFOUND
src/lib/gssapi/mechglue/g_context_time.c	usr/src/lib/libgss/g_context_time.c
src/lib/gssapi/mechglue/g_delete_sec_context.c	usr/src/lib/libgss/g_delete_sec_context.c
src/lib/gssapi/mechglue/g_dsp_name.c	usr/src/lib/libgss/g_dsp_name.c
src/lib/gssapi/mechglue/g_dsp_status.c	usr/src/lib/libgss/g_dsp_status.c
src/lib/gssapi/mechglue/g_dup_name.c	usr/src/lib/libgss/g_dup_name.c
src/lib/gssapi/mechglue/g_exp_sec_context.c	usr/src/lib/libgss/g_exp_sec_context.c
src/lib/gssapi/mechglue/g_export_name.c	usr/src/lib/libgss/g_export_name.c
src/lib/gssapi/mechglue/g_glue.c	usr/src/lib/libgss/g_glue.c
src/lib/gssapi/mechglue/g_imp_name.c	usr/src/lib/libgss/g_imp_name.c
src/lib/gssapi/mechglue/g_imp_sec_context.c	usr/src/lib/libgss/g_imp_sec_context.c
src/lib/gssapi/mechglue/g_init_sec_context.c	usr/src/lib/libgss/g_init_sec_context.c
src/lib/gssapi/mechglue/g_initialize.c	usr/src/lib/libgss/g_initialize.c
src/lib/gssapi/mechglue/g_inq_context.c	NOTFOUND
src/lib/gssapi/mechglue/g_inq_context_oid.c	usr/src/lib/libgss/g_inq_context_oid.c
src/lib/gssapi/mechglue/g_inq_cred.c	NOTFOUND
src/lib/gssapi/mechglue/g_inq_cred_oid.c	NOTFOUND
src/lib/gssapi/mechglue/g_inq_names.c	NOTFOUND
src/lib/gssapi/mechglue/g_mech_invoke.c	NOTFOUND
src/lib/gssapi/mechglue/g_mechname.c	NOTFOUND
src/lib/gssapi/mechglue/g_oid_ops.c	usr/src/lib/libgss/g_oid_ops.c
src/lib/gssapi/mechglue/g_process_context.c	usr/src/lib/libgss/g_process_context.c
src/lib/gssapi/mechglue/g_rel_buffer.c	usr/src/lib/libgss/g_rel_buffer.c
src/lib/gssapi/mechglue/g_rel_cred.c	usr/src/lib/libgss/g_rel_cred.c
src/lib/gssapi/mechglue/g_rel_name.c	usr/src/lib/libgss/g_rel_name.c
src/lib/gssapi/mechglue/g_rel_oid_set.c	usr/src/lib/libgss/g_rel_oid_set.c
src/lib/gssapi/mechglue/g_seal.c	usr/src/lib/libgss/g_seal.c
src/lib/gssapi/mechglue/g_set_context_option.c	NOTFOUND
src/lib/gssapi/mechglue/g_set_cred_option.c	NOTFOUND
src/lib/gssapi/mechglue/g_sign.c	usr/src/lib/libgss/g_sign.c
src/lib/gssapi/mechglue/g_store_cred.c	usr/src/lib/libgss/g_store_cred.c
src/lib/gssapi/mechglue/g_unseal.c	usr/src/lib/libgss/g_unseal.c
src/lib/gssapi/mechglue/g_unwrap_aead.c	NOTFOUND
src/lib/gssapi/mechglue/g_unwrap_iov.c	NOTFOUND
src/lib/gssapi/mechglue/g_userok.c	usr/src/lib/libgss/g_userok.c
src/lib/gssapi/mechglue/g_verify.c	usr/src/lib/libgss/g_verify.c
src/lib/gssapi/mechglue/g_wrap_aead.c	NOTFOUND
src/lib/gssapi/mechglue/g_wrap_iov.c	NOTFOUND
src/lib/gssapi/mechglue/gssd_pname_to_uid.c	usr/src/lib/libgss/gssd_pname_to_uid.c
src/lib/gssapi/mechglue/mechglue.h	NOTFOUND
src/lib/gssapi/mechglue/mglueP.h	usr/src/uts/common/gssapi/include/mglueP.h
src/lib/gssapi/spnego/gssapiP_spnego.h	usr/src/lib/gss_mechs/mech_spnego/mech/gssapiP_spnego.h
src/lib/gssapi/spnego/spnego_mech.c	usr/src/lib/gss_mechs/mech_spnego/mech/spnego_mech.c
src/lib/kadm5/adb.h	usr/src/lib/krb5/kadm5/adb.h
src/lib/kadm5/admin.h	usr/src/lib/krb5/kadm5/admin.h
src/lib/kadm5/admin_internal.h	usr/src/lib/krb5/kadm5/admin_internal.h
src/lib/kadm5/admin_xdr.h	usr/src/lib/krb5/kadm5/admin_xdr.h
src/lib/kadm5/alt_prof.c	usr/src/lib/krb5/kadm5/alt_prof.c
src/lib/kadm5/chpass_util.c	usr/src/lib/krb5/kadm5/chpass_util.c
src/lib/kadm5/clnt/client_handle.c	usr/src/lib/krb5/kadm5/clnt/client_handle.c
src/lib/kadm5/clnt/client_init.c	usr/src/lib/krb5/kadm5/clnt/client_init.c
src/lib/kadm5/clnt/client_internal.h	usr/src/lib/krb5/kadm5/clnt/client_internal.h
src/lib/kadm5/clnt/client_principal.c	usr/src/lib/krb5/kadm5/clnt/client_principal.c
src/lib/kadm5/clnt/client_rpc.c	usr/src/lib/krb5/kadm5/clnt/client_rpc.c
src/lib/kadm5/clnt/clnt_chpass_util.c	usr/src/lib/krb5/kadm5/clnt/clnt_chpass_util.c
src/lib/kadm5/clnt/clnt_policy.c	usr/src/lib/krb5/kadm5/clnt/clnt_policy.c
src/lib/kadm5/clnt/clnt_privs.c	usr/src/lib/krb5/kadm5/clnt/clnt_privs.c
src/lib/kadm5/kadm_rpc.h	usr/src/lib/krb5/kadm5/kadm_rpc.h
src/lib/kadm5/kadm_rpc_xdr.c	usr/src/lib/krb5/kadm5/kadm_rpc_xdr.c
src/lib/kadm5/logger.c	usr/src/lib/krb5/kadm5/clnt/logger.c
src/lib/kadm5/logger.c	usr/src/lib/krb5/kadm5/srv/logger.c
src/lib/kadm5/misc_free.c	usr/src/lib/krb5/kadm5/misc_free.c
src/lib/kadm5/ovsec_glue.c	NOTFOUND
src/lib/kadm5/server_internal.h	usr/src/lib/krb5/kadm5/server_internal.h
src/lib/kadm5/srv/adb_xdr.c	usr/src/lib/krb5/kadm5/srv/adb_xdr.c
src/lib/kadm5/srv/server_acl.c	usr/src/lib/krb5/kadm5/srv/server_acl.c
src/lib/kadm5/srv/server_acl.h	usr/src/lib/krb5/kadm5/srv/server_acl.h
src/lib/kadm5/srv/server_dict.c	usr/src/lib/krb5/kadm5/srv/server_dict.c
src/lib/kadm5/srv/server_handle.c	usr/src/lib/krb5/kadm5/srv/server_handle.c
src/lib/kadm5/srv/server_init.c	usr/src/lib/krb5/kadm5/srv/server_init.c
src/lib/kadm5/srv/server_kdb.c	usr/src/lib/krb5/kadm5/srv/server_kdb.c
src/lib/kadm5/srv/server_misc.c	usr/src/lib/krb5/kadm5/srv/server_misc.c
src/lib/kadm5/srv/svr_chpass_util.c	usr/src/lib/krb5/kadm5/srv/svr_chpass_util.c
src/lib/kadm5/srv/svr_iters.c	usr/src/lib/krb5/kadm5/srv/svr_iters.c
src/lib/kadm5/srv/svr_misc_free.c	usr/src/lib/krb5/kadm5/srv/svr_misc_free.c
src/lib/kadm5/srv/svr_policy.c	usr/src/lib/krb5/kadm5/srv/svr_policy.c
src/lib/kadm5/srv/svr_principal.c	usr/src/lib/krb5/kadm5/srv/svr_principal.c
src/lib/kadm5/str_conv.c	usr/src/lib/krb5/kadm5/str_conv.c
src/lib/kdb/decrypt_key.c	usr/src/lib/krb5/kdb/decrypt_key.c
src/lib/kdb/encrypt_key.c	usr/src/lib/krb5/kdb/encrypt_key.c
src/lib/kdb/iprop_xdr.c	NOTFOUND
src/lib/kdb/kdb5.c	usr/src/lib/krb5/kdb/kdb5.c
src/lib/kdb/kdb5.h	usr/src/lib/krb5/kdb/kdb5.h
src/lib/kdb/kdb5int.h	NOTFOUND
src/lib/kdb/kdb_convert.c	usr/src/lib/krb5/kdb/kdb_convert.c
src/lib/kdb/kdb_cpw.c	usr/src/lib/krb5/kdb/kdb_cpw.c
src/lib/kdb/kdb_default.c	usr/src/lib/krb5/kdb/kdb_default.c
src/lib/kdb/kdb_log.c	usr/src/lib/krb5/kdb/kdb_log.c
src/lib/kdb/keytab.c	usr/src/lib/krb5/kdb/keytab.c
src/lib/krb5/asn.1/asn1_decode.c	usr/src/lib/gss_mechs/mech_krb5/krb5/asn.1/asn1_decode.c
src/lib/krb5/asn.1/asn1_decode.h	usr/src/lib/gss_mechs/mech_krb5/krb5/asn.1/asn1_decode.h
src/lib/krb5/asn.1/asn1_encode.c	usr/src/lib/gss_mechs/mech_krb5/krb5/asn.1/asn1_encode.c
src/lib/krb5/asn.1/asn1_encode.h	usr/src/lib/gss_mechs/mech_krb5/krb5/asn.1/asn1_encode.h
src/lib/krb5/asn.1/asn1_get.c	usr/src/lib/gss_mechs/mech_krb5/krb5/asn.1/asn1_get.c
src/lib/krb5/asn.1/asn1_get.h	usr/src/lib/gss_mechs/mech_krb5/krb5/asn.1/asn1_get.h
src/lib/krb5/asn.1/asn1_k_decode.c	usr/src/lib/gss_mechs/mech_krb5/krb5/asn.1/asn1_k_decode.c
src/lib/krb5/asn.1/asn1_k_decode.h	usr/src/lib/gss_mechs/mech_krb5/krb5/asn.1/asn1_k_decode.h
src/lib/krb5/asn.1/asn1_k_encode.c	usr/src/lib/gss_mechs/mech_krb5/krb5/asn.1/asn1_k_encode.c
src/lib/krb5/asn.1/asn1_k_encode.h	usr/src/lib/gss_mechs/mech_krb5/krb5/asn.1/asn1_k_encode.h
src/lib/krb5/asn.1/asn1_make.c	usr/src/lib/gss_mechs/mech_krb5/krb5/asn.1/asn1_make.c
src/lib/krb5/asn.1/asn1_make.h	usr/src/lib/gss_mechs/mech_krb5/krb5/asn.1/asn1_make.h
src/lib/krb5/asn.1/asn1_misc.c	usr/src/lib/gss_mechs/mech_krb5/krb5/asn.1/asn1_misc.c
src/lib/krb5/asn.1/asn1_misc.h	usr/src/lib/gss_mechs/mech_krb5/krb5/asn.1/asn1_misc.h
src/lib/krb5/asn.1/asn1buf.c	usr/src/lib/gss_mechs/mech_krb5/krb5/asn.1/asn1buf.c
src/lib/krb5/asn.1/asn1buf.h	usr/src/lib/gss_mechs/mech_krb5/krb5/asn.1/asn1buf.h
src/lib/krb5/asn.1/asn1glue.h	NOTFOUND
src/lib/krb5/asn.1/krb5_decode.c	usr/src/lib/gss_mechs/mech_krb5/krb5/asn.1/krb5_decode.c
src/lib/krb5/asn.1/krb5_encode.c	usr/src/lib/gss_mechs/mech_krb5/krb5/asn.1/krb5_encode.c
src/lib/krb5/asn.1/krbasn1.h	usr/src/lib/gss_mechs/mech_krb5/krb5/asn.1/krbasn1.h
src/lib/krb5/asn.1/ldap_key_seq.c	usr/src/lib/gss_mechs/mech_krb5/krb5/asn.1/ldap_key_seq.c
src/lib/krb5/ccache/cc-int.h	usr/src/lib/gss_mechs/mech_krb5/krb5/ccache/cc-int.h
src/lib/krb5/ccache/cc_file.c	usr/src/lib/gss_mechs/mech_krb5/krb5/ccache/cc_file.c
src/lib/krb5/ccache/cc_keyring.c	NOTFOUND
src/lib/krb5/ccache/cc_memory.c	usr/src/lib/gss_mechs/mech_krb5/krb5/ccache/cc_memory.c
src/lib/krb5/ccache/cc_mslsa.c	NOTFOUND
src/lib/krb5/ccache/cc_retr.c	usr/src/lib/gss_mechs/mech_krb5/krb5/ccache/cc_retr.c
src/lib/krb5/ccache/ccbase.c	usr/src/lib/gss_mechs/mech_krb5/krb5/ccache/ccbase.c
src/lib/krb5/ccache/cccopy.c	usr/src/lib/gss_mechs/mech_krb5/krb5/ccache/cccopy.c
src/lib/krb5/ccache/cccursor.c	NOTFOUND
src/lib/krb5/ccache/ccdefault.c	usr/src/lib/gss_mechs/mech_krb5/krb5/ccache/ccdefault.c
src/lib/krb5/ccache/ccdefops.c	usr/src/lib/gss_mechs/mech_krb5/krb5/ccache/ccdefops.c
src/lib/krb5/ccache/ccfns.c	usr/src/lib/gss_mechs/mech_krb5/krb5/ccache/ccfns.c
src/lib/krb5/ccache/fcc.h	usr/src/lib/gss_mechs/mech_krb5/krb5/ccache/fcc.h
src/lib/krb5/ccache/scc.h	usr/src/lib/gss_mechs/mech_krb5/krb5/ccache/scc.h
src/lib/krb5/ccache/ser_cc.c	usr/src/lib/gss_mechs/mech_krb5/krb5/ccache/ser_cc.c
src/lib/krb5/error_tables/init_ets.c	NOTFOUND
src/lib/krb5/keytab/kt-int.h	usr/src/lib/gss_mechs/mech_krb5/krb5/keytab/kt-int.h
src/lib/krb5/keytab/kt_file.c	usr/src/lib/gss_mechs/mech_krb5/krb5/keytab/kt_file.c
src/lib/krb5/keytab/kt_memory.c	NOTFOUND
src/lib/krb5/keytab/kt_srvtab.c	usr/src/lib/gss_mechs/mech_krb5/krb5/keytab/kt_srvtab.c
src/lib/krb5/keytab/ktadd.c	usr/src/lib/gss_mechs/mech_krb5/krb5/keytab/ktadd.c
src/lib/krb5/keytab/ktbase.c	usr/src/lib/gss_mechs/mech_krb5/krb5/keytab/ktbase.c
src/lib/krb5/keytab/ktdefault.c	usr/src/lib/gss_mechs/mech_krb5/krb5/keytab/ktdefault.c
src/lib/krb5/keytab/ktfns.c	usr/src/lib/gss_mechs/mech_krb5/krb5/keytab/ktfns.c
src/lib/krb5/keytab/ktfr_entry.c	usr/src/lib/gss_mechs/mech_krb5/krb5/keytab/ktfr_entry.c
src/lib/krb5/keytab/ktremove.c	usr/src/lib/gss_mechs/mech_krb5/krb5/keytab/ktremove.c
src/lib/krb5/keytab/read_servi.c	usr/src/lib/gss_mechs/mech_krb5/krb5/keytab/read_servi.c
src/lib/krb5/krb/addr_comp.c	usr/src/lib/gss_mechs/mech_krb5/krb5/krb/addr_comp.c
src/lib/krb5/krb/addr_order.c	usr/src/lib/gss_mechs/mech_krb5/krb5/krb/addr_order.c
src/lib/krb5/krb/addr_srch.c	usr/src/lib/gss_mechs/mech_krb5/krb5/krb/addr_srch.c
src/lib/krb5/krb/appdefault.c	usr/src/lib/gss_mechs/mech_krb5/krb5/krb/appdefault.c
src/lib/krb5/krb/auth_con.c	usr/src/lib/gss_mechs/mech_krb5/krb5/krb/auth_con.c
src/lib/krb5/krb/auth_con.h	usr/src/uts/common/gssapi/mechs/krb5/include/auth_con.h
src/lib/krb5/krb/bld_pr_ext.c	usr/src/lib/gss_mechs/mech_krb5/krb5/krb/bld_pr_ext.c
src/lib/krb5/krb/bld_princ.c	usr/src/lib/gss_mechs/mech_krb5/krb5/krb/bld_princ.c
src/lib/krb5/krb/brand.c	usr/src/uts/common/os/brand.c
src/lib/krb5/krb/chk_trans.c	usr/src/lib/gss_mechs/mech_krb5/krb5/krb/chk_trans.c
src/lib/krb5/krb/chpw.c	usr/src/lib/gss_mechs/mech_krb5/krb5/krb/chpw.c
src/lib/krb5/krb/cleanup.h	usr/src/lib/gss_mechs/mech_krb5/krb5/krb/cleanup.h
src/lib/krb5/krb/conv_creds.c	NOTFOUND
src/lib/krb5/krb/conv_princ.c	usr/src/lib/gss_mechs/mech_krb5/krb5/krb/conv_princ.c
src/lib/krb5/krb/copy_addrs.c	usr/src/lib/gss_mechs/mech_krb5/krb5/krb/copy_addrs.c
src/lib/krb5/krb/copy_athctr.c	usr/src/uts/common/gssapi/mechs/krb5/krb5/krb/copy_athctr.c
src/lib/krb5/krb/copy_auth.c	usr/src/uts/common/gssapi/mechs/krb5/krb5/krb/copy_auth.c
src/lib/krb5/krb/copy_cksum.c	usr/src/uts/common/gssapi/mechs/krb5/krb5/krb/copy_cksum.c
src/lib/krb5/krb/copy_creds.c	usr/src/lib/gss_mechs/mech_krb5/krb5/krb/copy_creds.c
src/lib/krb5/krb/copy_data.c	usr/src/lib/gss_mechs/mech_krb5/krb5/krb/copy_data.c
src/lib/krb5/krb/copy_key.c	usr/src/uts/common/gssapi/mechs/krb5/krb5/krb/copy_key.c
src/lib/krb5/krb/copy_princ.c	usr/src/uts/common/gssapi/mechs/krb5/krb5/krb/copy_princ.c
src/lib/krb5/krb/copy_tick.c	usr/src/lib/gss_mechs/mech_krb5/krb5/krb/copy_tick.c
src/lib/krb5/krb/cp_key_cnt.c	usr/src/lib/gss_mechs/mech_krb5/krb5/krb/cp_key_cnt.c
src/lib/krb5/krb/decode_kdc.c	usr/src/lib/gss_mechs/mech_krb5/krb5/krb/decode_kdc.c
src/lib/krb5/krb/decrypt_tk.c	usr/src/lib/gss_mechs/mech_krb5/krb5/krb/decrypt_tk.c
src/lib/krb5/krb/deltat.c	usr/src/lib/gss_mechs/mech_krb5/krb5/krb/deltat.c
src/lib/krb5/krb/enc_helper.c	usr/src/lib/gss_mechs/mech_krb5/krb5/krb/enc_helper.c
src/lib/krb5/krb/encode_kdc.c	usr/src/lib/gss_mechs/mech_krb5/krb5/krb/encode_kdc.c
src/lib/krb5/krb/encrypt_tk.c	usr/src/lib/gss_mechs/mech_krb5/krb5/krb/encrypt_tk.c
src/lib/krb5/krb/fast.c	NOTFOUND
src/lib/krb5/krb/fast.h	NOTFOUND
src/lib/krb5/krb/free_rtree.c	usr/src/lib/gss_mechs/mech_krb5/krb5/krb/free_rtree.c
src/lib/krb5/krb/fwd_tgt.c	usr/src/lib/gss_mechs/mech_krb5/krb5/krb/fwd_tgt.c
src/lib/krb5/krb/gc_frm_kdc.c	usr/src/lib/gss_mechs/mech_krb5/krb5/krb/gc_frm_kdc.c
src/lib/krb5/krb/gc_via_tkt.c	usr/src/lib/gss_mechs/mech_krb5/krb5/krb/gc_via_tkt.c
src/lib/krb5/krb/gen_seqnum.c	usr/src/lib/gss_mechs/mech_krb5/krb5/krb/gen_seqnum.c
src/lib/krb5/krb/gen_subkey.c	usr/src/lib/gss_mechs/mech_krb5/krb5/krb/gen_subkey.c
src/lib/krb5/krb/get_creds.c	usr/src/lib/gss_mechs/mech_krb5/krb5/krb/get_creds.c
src/lib/krb5/krb/get_in_tkt.c	usr/src/lib/gss_mechs/mech_krb5/krb5/krb/get_in_tkt.c
src/lib/krb5/krb/gic_keytab.c	usr/src/lib/gss_mechs/mech_krb5/krb5/krb/gic_keytab.c
src/lib/krb5/krb/gic_opt.c	usr/src/lib/gss_mechs/mech_krb5/krb5/krb/gic_opt.c
src/lib/krb5/krb/gic_pwd.c	usr/src/lib/gss_mechs/mech_krb5/krb5/krb/gic_pwd.c
src/lib/krb5/krb/in_tkt_sky.c	NOTFOUND
src/lib/krb5/krb/init_ctx.c	usr/src/uts/common/gssapi/mechs/krb5/krb5/krb/init_ctx.c
src/lib/krb5/krb/init_keyblock.c	usr/src/lib/gss_mechs/mech_krb5/krb5/krb/init_keyblock.c
src/lib/krb5/krb/int-proto.h	usr/src/lib/gss_mechs/mech_krb5/krb5/krb/int-proto.h
src/lib/krb5/krb/kdc_rep_dc.c	usr/src/lib/gss_mechs/mech_krb5/krb5/krb/kdc_rep_dc.c
src/lib/krb5/krb/kerrs.c	usr/src/lib/gss_mechs/mech_krb5/krb5/krb/kerrs.c
src/lib/krb5/krb/kfree.c	usr/src/uts/common/gssapi/mechs/krb5/krb5/krb/kfree.c
src/lib/krb5/krb/mk_cred.c	usr/src/lib/gss_mechs/mech_krb5/krb5/krb/mk_cred.c
src/lib/krb5/krb/mk_error.c	usr/src/lib/gss_mechs/mech_krb5/krb5/krb/mk_error.c
src/lib/krb5/krb/mk_priv.c	usr/src/lib/gss_mechs/mech_krb5/krb5/krb/mk_priv.c
src/lib/krb5/krb/mk_rep.c	usr/src/lib/gss_mechs/mech_krb5/krb5/krb/mk_rep.c
src/lib/krb5/krb/mk_req.c	usr/src/lib/gss_mechs/mech_krb5/krb5/krb/mk_req.c
src/lib/krb5/krb/mk_req_ext.c	usr/src/lib/gss_mechs/mech_krb5/krb5/krb/mk_req_ext.c
src/lib/krb5/krb/mk_safe.c	usr/src/lib/gss_mechs/mech_krb5/krb5/krb/mk_safe.c
src/lib/krb5/krb/pac.c	usr/src/lib/gss_mechs/mech_krb5/krb5/krb/pac.c
src/lib/krb5/krb/parse.c	usr/src/uts/common/gssapi/mechs/krb5/krb5/krb/parse.c
src/lib/krb5/krb/pkinit_apple_asn1.c	NOTFOUND
src/lib/krb5/krb/pkinit_apple_cert_store.c	NOTFOUND
src/lib/krb5/krb/pkinit_apple_client.c	NOTFOUND
src/lib/krb5/krb/pkinit_apple_cms.c	NOTFOUND
src/lib/krb5/krb/pkinit_apple_utils.c	NOTFOUND
src/lib/krb5/krb/pr_to_salt.c	usr/src/lib/gss_mechs/mech_krb5/krb5/krb/pr_to_salt.c
src/lib/krb5/krb/preauth.c	usr/src/lib/gss_mechs/mech_krb5/krb5/krb/preauth.c
src/lib/krb5/krb/preauth2.c	usr/src/lib/gss_mechs/mech_krb5/krb5/krb/preauth2.c
src/lib/krb5/krb/princ_comp.c	usr/src/lib/gss_mechs/mech_krb5/krb5/krb/princ_comp.c
src/lib/krb5/krb/rd_cred.c	usr/src/lib/gss_mechs/mech_krb5/krb5/krb/rd_cred.c
src/lib/krb5/krb/rd_error.c	usr/src/lib/gss_mechs/mech_krb5/krb5/krb/rd_error.c
src/lib/krb5/krb/rd_priv.c	usr/src/lib/gss_mechs/mech_krb5/krb5/krb/rd_priv.c
src/lib/krb5/krb/rd_rep.c	usr/src/lib/gss_mechs/mech_krb5/krb5/krb/rd_rep.c
src/lib/krb5/krb/rd_req.c	usr/src/lib/gss_mechs/mech_krb5/krb5/krb/rd_req.c
src/lib/krb5/krb/rd_req_dec.c	usr/src/lib/gss_mechs/mech_krb5/krb5/krb/rd_req_dec.c
src/lib/krb5/krb/rd_safe.c	usr/src/lib/gss_mechs/mech_krb5/krb5/krb/rd_safe.c
src/lib/krb5/krb/recvauth.c	usr/src/lib/gss_mechs/mech_krb5/krb5/krb/recvauth.c
src/lib/krb5/krb/send_tgs.c	usr/src/lib/gss_mechs/mech_krb5/krb5/krb/send_tgs.c
src/lib/krb5/krb/sendauth.c	usr/src/lib/gss_mechs/mech_krb5/krb5/krb/sendauth.c
src/lib/krb5/krb/ser_actx.c	usr/src/uts/common/gssapi/mechs/krb5/krb5/krb/ser_actx.c
src/lib/krb5/krb/ser_adata.c	usr/src/uts/common/gssapi/mechs/krb5/krb5/krb/ser_adata.c
src/lib/krb5/krb/ser_addr.c	usr/src/uts/common/gssapi/mechs/krb5/krb5/krb/ser_addr.c
src/lib/krb5/krb/ser_auth.c	usr/src/uts/common/gssapi/mechs/krb5/krb5/krb/ser_auth.c
src/lib/krb5/krb/ser_cksum.c	usr/src/uts/common/gssapi/mechs/krb5/krb5/krb/ser_cksum.c
src/lib/krb5/krb/ser_ctx.c	usr/src/uts/common/gssapi/mechs/krb5/krb5/krb/ser_ctx.c
src/lib/krb5/krb/ser_eblk.c	NOTFOUND
src/lib/krb5/krb/ser_key.c	usr/src/uts/common/gssapi/mechs/krb5/krb5/krb/ser_key.c
src/lib/krb5/krb/ser_princ.c	usr/src/uts/common/gssapi/mechs/krb5/krb5/krb/ser_princ.c
src/lib/krb5/krb/serialize.c	usr/src/uts/common/gssapi/mechs/krb5/krb5/krb/serialize.c
src/lib/krb5/krb/set_realm.c	usr/src/lib/gss_mechs/mech_krb5/krb5/krb/set_realm.c
src/lib/krb5/krb/srv_dec_tkt.c	NOTFOUND
src/lib/krb5/krb/srv_rcache.c	usr/src/lib/gss_mechs/mech_krb5/krb5/krb/srv_rcache.c
src/lib/krb5/krb/str_conv.c	usr/src/lib/gss_mechs/mech_krb5/krb5/krb/str_conv.c
src/lib/krb5/krb/strftime.c	NO
src/lib/krb5/krb/strptime.c	NO
src/lib/krb5/krb/tgtname.c	usr/src/lib/gss_mechs/mech_krb5/krb5/krb/tgtname.c
src/lib/krb5/krb/unparse.c	usr/src/uts/common/gssapi/mechs/krb5/krb5/krb/unparse.c
src/lib/krb5/krb/valid_times.c	usr/src/lib/gss_mechs/mech_krb5/krb5/krb/valid_times.c
src/lib/krb5/krb/vfy_increds.c	usr/src/lib/gss_mechs/mech_krb5/krb5/krb/vfy_increds.c
src/lib/krb5/krb/vic_opt.c	usr/src/lib/gss_mechs/mech_krb5/krb5/krb/vic_opt.c
src/lib/krb5/krb/walk_rtree.c	usr/src/lib/gss_mechs/mech_krb5/krb5/krb/walk_rtree.c
src/lib/krb5/krb5_libinit.c	usr/src/lib/gss_mechs/mech_krb5/krb5/krb/krb5_libinit.c
src/lib/krb5/krb5_libinit.h	usr/src/lib/gss_mechs/mech_krb5/include/krb5_libinit.h
src/lib/krb5/os/accessor.c	usr/src/lib/gss_mechs/mech_krb5/krb5/os/accessor.c
src/lib/krb5/os/an_to_ln.c	usr/src/lib/gss_mechs/mech_krb5/krb5/os/an_to_ln.c
src/lib/krb5/os/c_ustime.c	usr/src/uts/common/gssapi/mechs/krb5/krb5/os/c_ustime.c
src/lib/krb5/os/ccdefname.c	usr/src/lib/gss_mechs/mech_krb5/krb5/os/ccdefname.c
src/lib/krb5/os/changepw.c	usr/src/lib/gss_mechs/mech_krb5/krb5/os/changepw.c
src/lib/krb5/os/def_realm.c	usr/src/lib/gss_mechs/mech_krb5/krb5/os/def_realm.c
src/lib/krb5/os/dnsglue.c	usr/src/lib/gss_mechs/mech_krb5/krb5/os/dnsglue.c
src/lib/krb5/os/dnsglue.h	usr/src/lib/gss_mechs/mech_krb5/krb5/os/dnsglue.h
src/lib/krb5/os/dnssrv.c	usr/src/lib/gss_mechs/mech_krb5/krb5/os/dnssrv.c
src/lib/krb5/os/free_hstrl.c	usr/src/lib/gss_mechs/mech_krb5/krb5/os/free_hstrl.c
src/lib/krb5/os/free_krbhs.c	usr/src/lib/gss_mechs/mech_krb5/krb5/os/free_krbhs.c
src/lib/krb5/os/full_ipadr.c	usr/src/lib/gss_mechs/mech_krb5/krb5/os/full_ipadr.c
src/lib/krb5/os/gen_port.c	usr/src/lib/gss_mechs/mech_krb5/krb5/os/gen_port.c
src/lib/krb5/os/gen_rname.c	usr/src/lib/gss_mechs/mech_krb5/krb5/os/gen_rname.c
src/lib/krb5/os/genaddrs.c	usr/src/lib/gss_mechs/mech_krb5/krb5/os/genaddrs.c
src/lib/krb5/os/get_krbhst.c	usr/src/lib/gss_mechs/mech_krb5/krb5/os/get_krbhst.c
src/lib/krb5/os/hostaddr.c	usr/src/lib/gss_mechs/mech_krb5/krb5/os/hostaddr.c
src/lib/krb5/os/hst_realm.c	usr/src/lib/gss_mechs/mech_krb5/krb5/os/hst_realm.c
src/lib/krb5/os/init_os_ctx.c	usr/src/uts/common/gssapi/mechs/krb5/krb5/os/init_os_ctx.c
src/lib/krb5/os/krbfileio.c	usr/src/lib/gss_mechs/mech_krb5/krb5/os/krbfileio.c
src/lib/krb5/os/ktdefname.c	usr/src/lib/gss_mechs/mech_krb5/krb5/os/ktdefname.c
src/lib/krb5/os/kuserok.c	usr/src/lib/gss_mechs/mech_krb5/krb5/os/kuserok.c
src/lib/krb5/os/localaddr.c	usr/src/lib/gss_mechs/mech_krb5/krb5/os/localaddr.c
src/lib/krb5/os/locate_kdc.c	usr/src/lib/gss_mechs/mech_krb5/krb5/os/locate_kdc.c
src/lib/krb5/os/lock_file.c	usr/src/lib/gss_mechs/mech_krb5/krb5/os/lock_file.c
src/lib/krb5/os/mk_faddr.c	usr/src/lib/gss_mechs/mech_krb5/krb5/os/mk_faddr.c
src/lib/krb5/os/net_read.c	usr/src/lib/gss_mechs/mech_krb5/krb5/os/net_read.c
src/lib/krb5/os/net_write.c	usr/src/lib/gss_mechs/mech_krb5/krb5/os/net_write.c
src/lib/krb5/os/os-proto.h	usr/src/lib/gss_mechs/mech_krb5/krb5/os/os-proto.h
src/lib/krb5/os/osconfig.c	usr/src/lib/gss_mechs/mech_krb5/krb5/os/osconfig.c
src/lib/krb5/os/port2ip.c	usr/src/lib/gss_mechs/mech_krb5/krb5/os/port2ip.c
src/lib/krb5/os/prompter.c	usr/src/lib/gss_mechs/mech_krb5/krb5/os/prompter.c
src/lib/krb5/os/promptusr.c	usr/src/lib/gss_mechs/mech_krb5/krb5/os/promptusr.c
src/lib/krb5/os/read_msg.c	usr/src/lib/gss_mechs/mech_krb5/krb5/os/read_msg.c
src/lib/krb5/os/read_pwd.c	usr/src/lib/gss_mechs/mech_krb5/krb5/os/read_pwd.c
src/lib/krb5/os/realm_dom.c	usr/src/lib/gss_mechs/mech_krb5/krb5/os/realm_dom.c
src/lib/krb5/os/realm_iter.c	usr/src/lib/gss_mechs/mech_krb5/krb5/os/realm_iter.c
src/lib/krb5/os/sendto_kdc.c	usr/src/lib/gss_mechs/mech_krb5/krb5/os/sendto_kdc.c
src/lib/krb5/os/sn2princ.c	usr/src/lib/gss_mechs/mech_krb5/krb5/os/sn2princ.c
src/lib/krb5/os/thread_safe.c	usr/src/lib/gss_mechs/mech_krb5/krb5/os/thread_safe.c
src/lib/krb5/os/timeofday.c	usr/src/uts/common/gssapi/mechs/krb5/krb5/os/timeofday.c
src/lib/krb5/os/toffset.c	usr/src/uts/common/gssapi/mechs/krb5/krb5/os/toffset.c
src/lib/krb5/os/unlck_file.c	usr/src/lib/gss_mechs/mech_krb5/krb5/os/unlck_file.c
src/lib/krb5/os/ustime.c	usr/src/lib/gss_mechs/mech_krb5/krb5/os/ustime.c
src/lib/krb5/os/write_msg.c	usr/src/lib/gss_mechs/mech_krb5/krb5/os/write_msg.c
src/lib/krb5/posix/syslog.c	NO
src/lib/krb5/rcache/rc-int.h	usr/src/lib/gss_mechs/mech_krb5/krb5/rcache/rc-int.h
src/lib/krb5/rcache/rc_base.c	usr/src/lib/gss_mechs/mech_krb5/krb5/rcache/rc_base.c
src/lib/krb5/rcache/rc_base.h	usr/src/lib/gss_mechs/mech_krb5/krb5/rcache/rc_base.h
src/lib/krb5/rcache/rc_conv.c	usr/src/lib/gss_mechs/mech_krb5/krb5/rcache/rc_conv.c
src/lib/krb5/rcache/rc_dfl.c	NOTFOUND
src/lib/krb5/rcache/rc_dfl.h	NOTFOUND
src/lib/krb5/rcache/rc_io.c	usr/src/lib/gss_mechs/mech_krb5/krb5/rcache/rc_io.c
src/lib/krb5/rcache/rc_io.h	usr/src/lib/gss_mechs/mech_krb5/krb5/rcache/rc_io.h
src/lib/krb5/rcache/rc_none.c	usr/src/lib/gss_mechs/mech_krb5/krb5/rcache/rc_none.c
src/lib/krb5/rcache/rcdef.c	usr/src/lib/gss_mechs/mech_krb5/krb5/rcache/rcdef.c
src/lib/krb5/rcache/rcfns.c	usr/src/lib/gss_mechs/mech_krb5/krb5/rcache/rcfns.c
src/lib/krb5/rcache/ser_rc.c	usr/src/lib/gss_mechs/mech_krb5/krb5/rcache/ser_rc.c
src/lib/win_glue.c	NOTFOUND
src/patchlevel.h	NOBUTMAYBE
src/plugins/authdata/greet/greet_auth.c	NOTFOUND
src/plugins/kdb/db2/adb_openclose.c	usr/src/lib/krb5/plugins/kdb/db2/adb_openclose.c
src/plugins/kdb/db2/adb_policy.c	usr/src/lib/krb5/plugins/kdb/db2/adb_policy.c
src/plugins/kdb/db2/db2_exp.c	usr/src/lib/krb5/plugins/kdb/db2/db2_exp.c
src/plugins/kdb/db2/kdb_db2.c	usr/src/lib/krb5/plugins/kdb/db2/kdb_db2.c
src/plugins/kdb/db2/kdb_db2.h	usr/src/lib/krb5/plugins/kdb/db2/kdb_db2.h
src/plugins/kdb/db2/kdb_xdr.c	usr/src/lib/krb5/plugins/kdb/db2/kdb_xdr.c
src/plugins/kdb/db2/kdb_xdr.h	usr/src/lib/krb5/plugins/kdb/db2/kdb_xdr.h
src/plugins/kdb/db2/libdb2/btree/bt_close.c	usr/src/lib/krb5/plugins/kdb/db2/libdb2/btree/bt_close.c
src/plugins/kdb/db2/libdb2/btree/bt_conv.c	usr/src/lib/krb5/plugins/kdb/db2/libdb2/btree/bt_conv.c
src/plugins/kdb/db2/libdb2/btree/bt_debug.c	usr/src/lib/krb5/plugins/kdb/db2/libdb2/btree/bt_debug.c
src/plugins/kdb/db2/libdb2/btree/bt_delete.c	usr/src/lib/krb5/plugins/kdb/db2/libdb2/btree/bt_delete.c
src/plugins/kdb/db2/libdb2/btree/bt_get.c	usr/src/lib/krb5/plugins/kdb/db2/libdb2/btree/bt_get.c
src/plugins/kdb/db2/libdb2/btree/bt_open.c	usr/src/lib/krb5/plugins/kdb/db2/libdb2/btree/bt_open.c
src/plugins/kdb/db2/libdb2/btree/bt_overflow.c	usr/src/lib/krb5/plugins/kdb/db2/libdb2/btree/bt_overflow.c
src/plugins/kdb/db2/libdb2/btree/bt_page.c	usr/src/lib/krb5/plugins/kdb/db2/libdb2/btree/bt_page.c
src/plugins/kdb/db2/libdb2/btree/bt_put.c	usr/src/lib/krb5/plugins/kdb/db2/libdb2/btree/bt_put.c
src/plugins/kdb/db2/libdb2/btree/bt_search.c	usr/src/lib/krb5/plugins/kdb/db2/libdb2/btree/bt_search.c
src/plugins/kdb/db2/libdb2/btree/bt_seq.c	usr/src/lib/krb5/plugins/kdb/db2/libdb2/btree/bt_seq.c
src/plugins/kdb/db2/libdb2/btree/bt_split.c	usr/src/lib/krb5/plugins/kdb/db2/libdb2/btree/bt_split.c
src/plugins/kdb/db2/libdb2/btree/bt_utils.c	usr/src/lib/krb5/plugins/kdb/db2/libdb2/btree/bt_utils.c
src/plugins/kdb/db2/libdb2/btree/btree.h	usr/src/lib/krb5/plugins/kdb/db2/libdb2/btree/btree.h
src/plugins/kdb/db2/libdb2/btree/extern.h	usr/src/lib/krb5/plugins/kdb/db2/libdb2/btree/extern.h
src/plugins/kdb/db2/libdb2/db/db.c	usr/src/lib/krb5/plugins/kdb/db2/libdb2/db/db.c
src/plugins/kdb/db2/libdb2/hash/dbm.c	usr/src/lib/krb5/plugins/kdb/db2/libdb2/hash/dbm.c
src/plugins/kdb/db2/libdb2/hash/extern.h	usr/src/lib/krb5/plugins/kdb/db2/libdb2/hash/extern.h
src/plugins/kdb/db2/libdb2/hash/hash.c	usr/src/lib/krb5/plugins/kdb/db2/libdb2/hash/hash.c
src/plugins/kdb/db2/libdb2/hash/hash.h	usr/src/lib/krb5/plugins/kdb/db2/libdb2/hash/hash.h
src/plugins/kdb/db2/libdb2/hash/hash_bigkey.c	usr/src/lib/krb5/plugins/kdb/db2/libdb2/hash/hash_bigkey.c
src/plugins/kdb/db2/libdb2/hash/hash_debug.c	NOTFOUND
src/plugins/kdb/db2/libdb2/hash/hash_func.c	usr/src/lib/krb5/plugins/kdb/db2/libdb2/hash/hash_func.c
src/plugins/kdb/db2/libdb2/hash/hash_log2.c	usr/src/lib/krb5/plugins/kdb/db2/libdb2/hash/hash_log2.c
src/plugins/kdb/db2/libdb2/hash/hash_page.c	usr/src/lib/krb5/plugins/kdb/db2/libdb2/hash/hash_page.c
src/plugins/kdb/db2/libdb2/hash/hsearch.c	usr/src/lib/krb5/plugins/kdb/db2/libdb2/hash/hsearch.c
src/plugins/kdb/db2/libdb2/hash/page.h	usr/src/lib/krb5/plugins/kdb/db2/libdb2/hash/page.h
src/plugins/kdb/db2/libdb2/hash/search.h	usr/src/lib/krb5/plugins/kdb/db2/libdb2/hash/search.h
src/plugins/kdb/db2/libdb2/include/config.h	NO
src/plugins/kdb/db2/libdb2/include/db-config.h	usr/src/lib/gss_mechs/mech_krb5/include/db-config.h
src/plugins/kdb/db2/libdb2/include/db-dbm.h	NOTFOUND
src/plugins/kdb/db2/libdb2/include/db-int.h	usr/src/lib/krb5/plugins/kdb/db2/libdb2/include/db-int.h
src/plugins/kdb/db2/libdb2/include/db-ndbm.h	usr/src/lib/krb5/plugins/kdb/db2/libdb2/include/db-ndbm.h
src/plugins/kdb/db2/libdb2/include/db-queue.h	usr/src/lib/krb5/plugins/kdb/db2/libdb2/include/db-queue.h
src/plugins/kdb/db2/libdb2/include/db.h	usr/src/lib/gss_mechs/mech_krb5/include/db.h
src/plugins/kdb/db2/libdb2/mpool/mpool.c	usr/src/lib/krb5/plugins/kdb/db2/libdb2/mpool/mpool.c
src/plugins/kdb/db2/libdb2/mpool/mpool.h	usr/src/lib/krb5/plugins/kdb/db2/libdb2/mpool/mpool.h
src/plugins/kdb/db2/libdb2/recno/extern.h	usr/src/lib/krb5/plugins/kdb/db2/libdb2/recno/extern.h
src/plugins/kdb/db2/libdb2/recno/rec_close.c	usr/src/lib/krb5/plugins/kdb/db2/libdb2/recno/rec_close.c
src/plugins/kdb/db2/libdb2/recno/rec_delete.c	usr/src/lib/krb5/plugins/kdb/db2/libdb2/recno/rec_delete.c
src/plugins/kdb/db2/libdb2/recno/rec_get.c	usr/src/lib/krb5/plugins/kdb/db2/libdb2/recno/rec_get.c
src/plugins/kdb/db2/libdb2/recno/rec_open.c	usr/src/lib/krb5/plugins/kdb/db2/libdb2/recno/rec_open.c
src/plugins/kdb/db2/libdb2/recno/rec_put.c	usr/src/lib/krb5/plugins/kdb/db2/libdb2/recno/rec_put.c
src/plugins/kdb/db2/libdb2/recno/rec_search.c	usr/src/lib/krb5/plugins/kdb/db2/libdb2/recno/rec_search.c
src/plugins/kdb/db2/libdb2/recno/rec_seq.c	usr/src/lib/krb5/plugins/kdb/db2/libdb2/recno/rec_seq.c
src/plugins/kdb/db2/libdb2/recno/rec_utils.c	usr/src/lib/krb5/plugins/kdb/db2/libdb2/recno/rec_utils.c
src/plugins/kdb/db2/libdb2/recno/recno.h	usr/src/lib/krb5/plugins/kdb/db2/libdb2/recno/recno.h
src/plugins/kdb/db2/pol_xdr.c	usr/src/lib/krb5/plugins/kdb/db2/pol_xdr.c
src/plugins/kdb/db2/policy_db.h	usr/src/lib/krb5/plugins/kdb/db2/policy_db.h
src/plugins/kdb/ldap/ldap_exp.c	usr/src/lib/krb5/plugins/kdb/ldap/ldap_exp.c
src/plugins/kdb/ldap/ldap_util/kdb5_ldap_list.c	usr/src/cmd/krb5/ldap_util/kdb5_ldap_list.c
src/plugins/kdb/ldap/ldap_util/kdb5_ldap_list.h	usr/src/cmd/krb5/ldap_util/kdb5_ldap_list.h
src/plugins/kdb/ldap/ldap_util/kdb5_ldap_policy.c	usr/src/cmd/krb5/ldap_util/kdb5_ldap_policy.c
src/plugins/kdb/ldap/ldap_util/kdb5_ldap_policy.h	usr/src/cmd/krb5/ldap_util/kdb5_ldap_policy.h
src/plugins/kdb/ldap/ldap_util/kdb5_ldap_realm.c	usr/src/cmd/krb5/ldap_util/kdb5_ldap_realm.c
src/plugins/kdb/ldap/ldap_util/kdb5_ldap_realm.h	usr/src/cmd/krb5/ldap_util/kdb5_ldap_realm.h
src/plugins/kdb/ldap/ldap_util/kdb5_ldap_services.c	usr/src/cmd/krb5/ldap_util/kdb5_ldap_services.c
src/plugins/kdb/ldap/ldap_util/kdb5_ldap_services.h	usr/src/cmd/krb5/ldap_util/kdb5_ldap_services.h
src/plugins/kdb/ldap/ldap_util/kdb5_ldap_util.c	usr/src/cmd/krb5/ldap_util/kdb5_ldap_util.c
src/plugins/kdb/ldap/ldap_util/kdb5_ldap_util.h	usr/src/cmd/krb5/ldap_util/kdb5_ldap_util.h
src/plugins/kdb/ldap/libkdb_ldap/kdb_ldap.c	usr/src/lib/krb5/plugins/kdb/ldap/libkdb_ldap/kdb_ldap.c
src/plugins/kdb/ldap/libkdb_ldap/kdb_ldap.h	usr/src/lib/krb5/plugins/kdb/ldap/libkdb_ldap/kdb_ldap.h
src/plugins/kdb/ldap/libkdb_ldap/kdb_ldap_conn.c	usr/src/lib/krb5/plugins/kdb/ldap/libkdb_ldap/kdb_ldap_conn.c
src/plugins/kdb/ldap/libkdb_ldap/kdb_xdr.c	usr/src/lib/krb5/plugins/kdb/ldap/libkdb_ldap/kdb_xdr.c
src/plugins/kdb/ldap/libkdb_ldap/kdb_xdr.h	usr/src/lib/krb5/plugins/kdb/ldap/libkdb_ldap/kdb_xdr.h
src/plugins/kdb/ldap/libkdb_ldap/ldap_create.c	usr/src/lib/krb5/plugins/kdb/ldap/libkdb_ldap/ldap_create.c
src/plugins/kdb/ldap/libkdb_ldap/ldap_err.c	usr/src/lib/krb5/plugins/kdb/ldap/libkdb_ldap/ldap_err.c
src/plugins/kdb/ldap/libkdb_ldap/ldap_err.h	usr/src/lib/krb5/plugins/kdb/ldap/libkdb_ldap/ldap_err.h
src/plugins/kdb/ldap/libkdb_ldap/ldap_fetch_mkey.c	usr/src/lib/krb5/plugins/kdb/ldap/libkdb_ldap/ldap_fetch_mkey.c
src/plugins/kdb/ldap/libkdb_ldap/ldap_handle.c	usr/src/lib/krb5/plugins/kdb/ldap/libkdb_ldap/ldap_handle.c
src/plugins/kdb/ldap/libkdb_ldap/ldap_handle.h	usr/src/lib/krb5/plugins/kdb/ldap/libkdb_ldap/ldap_handle.h
src/plugins/kdb/ldap/libkdb_ldap/ldap_krbcontainer.c	usr/src/lib/krb5/plugins/kdb/ldap/libkdb_ldap/ldap_krbcontainer.c
src/plugins/kdb/ldap/libkdb_ldap/ldap_krbcontainer.h	usr/src/lib/krb5/plugins/kdb/ldap/libkdb_ldap/ldap_krbcontainer.h
src/plugins/kdb/ldap/libkdb_ldap/ldap_main.h	usr/src/lib/krb5/plugins/kdb/ldap/libkdb_ldap/ldap_main.h
src/plugins/kdb/ldap/libkdb_ldap/ldap_misc.c	usr/src/lib/krb5/plugins/kdb/ldap/libkdb_ldap/ldap_misc.c
src/plugins/kdb/ldap/libkdb_ldap/ldap_misc.h	usr/src/lib/krb5/plugins/kdb/ldap/libkdb_ldap/ldap_misc.h
src/plugins/kdb/ldap/libkdb_ldap/ldap_principal.c	usr/src/lib/krb5/plugins/kdb/ldap/libkdb_ldap/ldap_principal.c
src/plugins/kdb/ldap/libkdb_ldap/ldap_principal.h	usr/src/lib/krb5/plugins/kdb/ldap/libkdb_ldap/ldap_principal.h
src/plugins/kdb/ldap/libkdb_ldap/ldap_principal2.c	usr/src/lib/krb5/plugins/kdb/ldap/libkdb_ldap/ldap_principal2.c
src/plugins/kdb/ldap/libkdb_ldap/ldap_pwd_policy.c	usr/src/lib/krb5/plugins/kdb/ldap/libkdb_ldap/ldap_pwd_policy.c
src/plugins/kdb/ldap/libkdb_ldap/ldap_pwd_policy.h	usr/src/lib/krb5/plugins/kdb/ldap/libkdb_ldap/ldap_pwd_policy.h
src/plugins/kdb/ldap/libkdb_ldap/ldap_realm.c	usr/src/lib/krb5/plugins/kdb/ldap/libkdb_ldap/ldap_realm.c
src/plugins/kdb/ldap/libkdb_ldap/ldap_realm.h	usr/src/lib/krb5/plugins/kdb/ldap/libkdb_ldap/ldap_realm.h
src/plugins/kdb/ldap/libkdb_ldap/ldap_service_rights.c	usr/src/lib/krb5/plugins/kdb/ldap/libkdb_ldap/ldap_service_rights.c
src/plugins/kdb/ldap/libkdb_ldap/ldap_service_stash.c	usr/src/lib/krb5/plugins/kdb/ldap/libkdb_ldap/ldap_service_stash.c
src/plugins/kdb/ldap/libkdb_ldap/ldap_service_stash.h	usr/src/lib/krb5/plugins/kdb/ldap/libkdb_ldap/ldap_service_stash.h
src/plugins/kdb/ldap/libkdb_ldap/ldap_services.c	usr/src/lib/krb5/plugins/kdb/ldap/libkdb_ldap/ldap_services.c
src/plugins/kdb/ldap/libkdb_ldap/ldap_services.h	usr/src/lib/krb5/plugins/kdb/ldap/libkdb_ldap/ldap_services.h
src/plugins/kdb/ldap/libkdb_ldap/ldap_tkt_policy.c	usr/src/lib/krb5/plugins/kdb/ldap/libkdb_ldap/ldap_tkt_policy.c
src/plugins/kdb/ldap/libkdb_ldap/ldap_tkt_policy.h	usr/src/lib/krb5/plugins/kdb/ldap/libkdb_ldap/ldap_tkt_policy.h
src/plugins/kdb/ldap/libkdb_ldap/princ_xdr.c	usr/src/lib/krb5/plugins/kdb/ldap/libkdb_ldap/princ_xdr.c
src/plugins/kdb/ldap/libkdb_ldap/princ_xdr.h	usr/src/lib/krb5/plugins/kdb/ldap/libkdb_ldap/princ_xdr.h
src/plugins/locate/python/py-locate.c	NOTFOUND
src/plugins/preauth/cksum_body/cksum_body_main.c	NOTFOUND
src/plugins/preauth/encrypted_challenge/encrypted_challenge_main.c	NOTFOUND
src/plugins/preauth/fast_factor.h	NOTFOUND
src/plugins/preauth/pkinit/pkcs11.h	NO
src/plugins/preauth/pkinit/pkinit.h	usr/src/lib/krb5/plugins/preauth/pkinit/pkinit.h
src/plugins/preauth/pkinit/pkinit_accessor.c	usr/src/lib/krb5/plugins/preauth/pkinit/pkinit_accessor.c
src/plugins/preauth/pkinit/pkinit_accessor.h	usr/src/lib/krb5/plugins/preauth/pkinit/pkinit_accessor.h
src/plugins/preauth/pkinit/pkinit_clnt.c	usr/src/lib/krb5/plugins/preauth/pkinit/pkinit_clnt.c
src/plugins/preauth/pkinit/pkinit_crypto.h	usr/src/lib/krb5/plugins/preauth/pkinit/pkinit_crypto.h
src/plugins/preauth/pkinit/pkinit_crypto_openssl.c	usr/src/lib/krb5/plugins/preauth/pkinit/pkinit_crypto_openssl.c
src/plugins/preauth/pkinit/pkinit_crypto_openssl.h	usr/src/lib/krb5/plugins/preauth/pkinit/pkinit_crypto_openssl.h
src/plugins/preauth/pkinit/pkinit_identity.c	usr/src/lib/krb5/plugins/preauth/pkinit/pkinit_identity.c
src/plugins/preauth/pkinit/pkinit_lib.c	usr/src/lib/krb5/plugins/preauth/pkinit/pkinit_lib.c
src/plugins/preauth/pkinit/pkinit_matching.c	usr/src/lib/krb5/plugins/preauth/pkinit/pkinit_matching.c
src/plugins/preauth/pkinit/pkinit_profile.c	usr/src/lib/krb5/plugins/preauth/pkinit/pkinit_profile.c
src/plugins/preauth/pkinit/pkinit_srv.c	usr/src/lib/krb5/plugins/preauth/pkinit/pkinit_srv.c
src/plugins/preauth/wpse/wpse_main.c	NOTFOUND
src/prototype/getopt.c	NO
src/prototype/prototype.c	usr/src/prototypes/prototype.c
src/prototype/prototype.h	usr/src/prototypes/prototype.h
src/slave/kprop.c	usr/src/cmd/krb5/slave/kprop.c
src/slave/kprop.h	usr/src/cmd/krb5/slave/kprop.h
src/slave/kpropd.c	usr/src/cmd/krb5/slave/kpropd.c
src/slave/kpropd_rpc.c	usr/src/cmd/krb5/slave/kpropd_rpc.c
src/slave/kproplog.c	usr/src/cmd/krb5/kproplog/kproplog.c
src/util/et/com_err.c	usr/src/lib/gss_mechs/mech_krb5/et/com_err.c
src/util/et/com_err.h	usr/src/lib/gss_mechs/mech_krb5/include/com_err.h
src/util/et/compile_et.c	NOTFOUND
src/util/et/compiler.h	usr/src/lib/libcurses/screen/compiler.h
src/util/et/error_message.c	usr/src/lib/gss_mechs/mech_krb5/et/error_message.c
src/util/et/error_table.h	usr/src/lib/gss_mechs/mech_krb5/et/error_table.h
src/util/et/et_name.c	NOTFOUND
src/util/et/init_et.c	NOTFOUND
src/util/et/internal.h	usr/src/lib/gss_mechs/mech_krb5/et/internal.h
src/util/et/mit-sipb-copyright.h	usr/src/lib/gss_mechs/mech_krb5/et/mit-sipb-copyright.h
src/util/et/test_et.c	NOTFOUND
src/util/exitsleep.c	NOTFOUND
src/util/mac/k5_mig_client.c	NOTFOUND
src/util/mac/k5_mig_client.h	NOTFOUND
src/util/mac/k5_mig_server.c	NOTFOUND
src/util/mac/k5_mig_server.h	NOTFOUND
src/util/mac/k5_mig_types.h	NOTFOUND
src/util/profile/argv_parse.c	NOTFOUND
src/util/profile/argv_parse.h	NOTFOUND
src/util/profile/prof_FSp_glue.c	NOTFOUND
src/util/profile/prof_file.c	usr/src/lib/gss_mechs/mech_krb5/profile/prof_file.c
src/util/profile/prof_get.c	usr/src/lib/gss_mechs/mech_krb5/profile/prof_get.c
src/util/profile/prof_init.c	usr/src/lib/gss_mechs/mech_krb5/profile/prof_init.c
src/util/profile/prof_int.h	usr/src/lib/gss_mechs/mech_krb5/profile/prof_int.h
src/util/profile/prof_parse.c	usr/src/lib/gss_mechs/mech_krb5/profile/prof_parse.c
src/util/profile/prof_set.c	usr/src/lib/gss_mechs/mech_krb5/profile/prof_set.c
src/util/profile/prof_tree.c	usr/src/lib/gss_mechs/mech_krb5/profile/prof_tree.c
src/util/profile/profile_tcl.c	NOTFOUND
src/util/profile/test_parse.c	NOTFOUND
src/util/profile/test_profile.c	NOTFOUND
src/util/ss/copyright.h	usr/src/lib/krb5/ss/copyright.h
src/util/ss/data.c	usr/src/lib/krb5/ss/data.c
src/util/ss/error.c	usr/src/lib/krb5/ss/error.c
src/util/ss/execute_cmd.c	usr/src/lib/krb5/ss/execute_cmd.c
src/util/ss/help.c	usr/src/lib/krb5/ss/help.c
src/util/ss/invocation.c	usr/src/lib/krb5/ss/invocation.c
src/util/ss/list_rqs.c	usr/src/lib/krb5/ss/list_rqs.c
src/util/ss/listen.c	usr/src/lib/krb5/ss/listen.c
src/util/ss/mit-sipb-copyright.h	usr/src/lib/krb5/ss/mit-sipb-copyright.h
src/util/ss/mk_cmds.c	usr/src/lib/krb5/ss/mk_cmds.c
src/util/ss/options.c	usr/src/lib/krb5/ss/options.c
src/util/ss/pager.c	usr/src/lib/krb5/ss/pager.c
src/util/ss/parse.c	usr/src/lib/krb5/ss/parse.c
src/util/ss/prompt.c	usr/src/lib/krb5/ss/prompt.c
src/util/ss/request_tbl.c	usr/src/lib/krb5/ss/request_tbl.c
src/util/ss/requests.c	usr/src/lib/krb5/ss/requests.c
src/util/ss/ss.h	usr/src/lib/krb5/ss/ss.h
src/util/ss/ss_internal.h	usr/src/lib/krb5/ss/ss_internal.h
src/util/ss/test_ss.c	NOTFOUND
src/util/ss/utils.c	usr/src/lib/krb5/ss/utils.c
src/util/support/cache-addrinfo.h	usr/src/lib/gss_mechs/mech_krb5/include/cache-addrinfo.h
src/util/support/errors.c	usr/src/lib/gss_mechs/mech_krb5/support/errors.c
src/util/support/fake-addrinfo.c	usr/src/lib/gss_mechs/mech_krb5/support/fake-addrinfo.c
src/util/support/gmt_mktime.c	usr/src/lib/gss_mechs/mech_krb5/krb5/os/gmt_mktime.c
src/util/support/init-addrinfo.c	usr/src/lib/gss_mechs/mech_krb5/support/init-addrinfo.c
src/util/support/ipc_stream.c	NOTFOUND
src/util/support/k5buf-int.h	NOTFOUND
src/util/support/k5buf.c	NOTFOUND
src/util/support/mkstemp.c	NO
src/util/support/plugins.c	usr/src/lib/gss_mechs/mech_krb5/support/plugins.c
src/util/support/printf.c	NO
src/util/support/strlcpy.c	NO
src/util/support/supp-int.h	usr/src/lib/gss_mechs/mech_krb5/support/supp-int.h
src/util/support/threads.c	usr/src/lib/gss_mechs/mech_krb5/support/threads.c
src/util/support/utf8.c	usr/src/lib/gss_mechs/mech_krb5/support/utf8.c
src/util/support/utf8_conv.c	usr/src/lib/gss_mechs/mech_krb5/support/utf8_conv.c
src/wconfig.c	NOTFOUND
